20 20
10 1 10 1 20 1 66 1 20 1 20 1 20 1 20 1 61 1 62 1 56 1 56 1 56 1 20 1 20 1 20 1 20 1 20 1 10 1 10 1 
10 1 27 1 32 0 -1 0 -1 0 -1 0 -1 0 -1 0 -1 0 -1 0 -1 0 -1 0 -1 0 -1 0 -1 0 -1 0 -1 0 32 0 29 1 10 1 
11 1 32 0 48 0 32 0 -1 0 -1 0 -1 0 -1 0 -1 0 -1 0 -1 0 -1 0 -1 0 -1 0 -1 0 -1 0 32 0 38 0 32 0 11 1 
11 1 -1 0 32 0 -1 0 -1 0 -1 0 -1 0 -1 0 -1 0 -1 0 -1 0 -1 0 -1 0 -1 0 -1 0 -1 0 -1 0 32 0 -1 0 11 1 
30 1 32 0 34 0 32 0 -1 0 -1 0 -1 0 -1 0 -1 0 -1 0 -1 0 -1 0 71 1 -1 0 -1 0 -1 0 32 0 36 0 32 0 11 1 
30 1 47 1 32 0 -1 0 -1 0 -1 0 -1 0 -1 0 -1 0 -1 0 -1 0 -1 0 81 1 -1 0 -1 0 -1 0 -1 0 32 0 -1 0 11 1 
11 1 51 1 52 1 53 1 54 1 51 1 52 1 53 1 54 1 -1 0 -1 0 -1 0 -1 0 -1 0 -1 0 -1 0 -1 0 -1 0 -1 0 11 1 
11 1 27 1 -1 0 -1 0 -1 0 -1 0 -1 0 -1 0 -1 0 -1 0 -1 0 -1 0 -1 0 -1 0 -1 0 -1 0 -1 0 -1 0 -1 0 11 1 
11 1 -1 0 -1 0 -1 0 -1 0 -1 0 -1 0 -1 0 -1 0 -1 0 -1 0 58 1 58 1 -1 0 -1 0 -1 0 -1 0 -1 0 -1 0 30 1 
11 1 -1 0 -1 0 -1 0 -1 0 -1 0 -1 0 -1 0 -1 0 -1 0 -1 0 58 1 58 1 -1 0 -1 0 -1 0 -1 0 -1 0 -1 0 30 1 
11 1 -1 0 -1 0 -1 0 -1 0 -1 0 -1 0 -1 0 -1 0 -1 0 -1 0 -1 0 -1 0 -1 0 -1 0 -1 0 -1 0 -1 0 -1 0 11 1 
11 1 -1 0 -1 0 -1 0 -1 0 71 1 -1 0 -1 0 -1 0 -1 0 -1 0 -1 0 -1 0 -1 0 -1 0 -1 0 -1 0 -1 0 -1 0 11 1 
63 1 -1 0 -1 0 -1 0 -1 0 81 1 -1 0 -1 0 -1 0 -1 0 -1 0 -1 0 -1 0 10 1 10 1 -1 0 -1 0 10 1 10 1 11 1 
30 1 -1 0 -1 0 -1 0 -1 0 -1 0 -1 0 -1 0 -1 0 -1 0 -1 0 -1 0 -1 0 10 1 27 1 -1 0 -1 0 -1 0 -1 0 67 1 
30 1 -1 0 -1 0 -1 0 -1 0 -1 0 -1 0 -1 0 -1 0 -1 0 -1 0 -1 0 -1 0 10 1 -1 0 -1 0 -1 0 -1 0 -1 0 77 1 
30 1 -1 0 -1 0 -1 0 -1 0 -1 0 -1 0 -1 0 -1 0 -1 0 -1 0 -1 0 -1 0 10 1 -1 0 82 1 82 1 -1 0 -1 0 11 1 
11 1 -1 0 -1 0 -1 0 -1 0 -1 0 -1 0 -1 0 -1 0 -1 0 -1 0 -1 0 -1 0 10 1 -1 0 32 0 82 1 -1 0 -1 0 11 1 
11 1 -1 0 -1 0 -1 0 -1 0 -1 0 -1 0 -1 0 -1 0 -1 0 -1 0 -1 0 -1 0 10 1 -1 0 -1 0 -1 0 -1 0 -1 0 11 1 
11 1 47 1 -1 0 -1 0 -1 0 -1 0 -1 0 -1 0 -1 0 15 0 14 0 -1 0 -1 0 10 1 -1 0 -1 0 -1 0 -1 0 49 1 11 1 
11 1 11 1 11 1 11 1 11 1 11 1 11 1 11 1 11 1 25 0 24 0 11 1 11 1 11 1 11 1 30 1 30 1 11 1 11 1 11 1 
